Play=Play
Resume=Resume
Exit=Exit
Cancel=Cancel
OK=OK
NewPlayer=New Player
PlayerName=Player Name
Name=Name
Age=Age
Age?=Age?
EnterYourName=Enter Your Name
EnterYourAge=Enter Your Age
Start=Start
New=New
Highscore=Highscore
Profile=Profile
ChooseYourPlayer=Choose Your Player
Back=Back
Next=Next
NextLevel=Next
PauseMenu=Pause Menu
Previous=Previous
YourScore=Your Score
YourName?=Your Name?
MakeYouReadyForLevel=Make You ready for level {0}!
HUDScore=Score: {0}/{1}
HUDTime=Time: {0}
HUDLives=Lives: {0}
HUDHealth=Health: {0}
LevelEndTitle=Level Finished
LevelEndScore=Score: {0}
LevelEndScoreBonus=Bonus: {0}
LevelEndTime=Time: {0}
LevelEndTimeBonus=Time Bonus: {0}
GreenKey=Green Key