Play=Spielen
Resume=Fortsetzen
Exit=Abbrechen
Cancel=Abbrechen
OK=OK
NewPlayer=Neuer Spieler
PlayerName=Spielername
Name=Name
Age=Alter
Age?=Alter?
EnterYourName=Gib deinen Namen ein
EnterYourAge=Gib dein Alter ein
Start=Start
StartChooseLevel=Welten
StartChooseStory=Geschichten
New=Neu
Highscore=Bestenliste
Profile=Profil
ChooseYourPlayer=Wähle deinen Spieler
Back=Zurück
Next=Nächster
NextLevel=Weiter
PauseMenu=Pausenmenu
Previous=Vorheriger
YourScore=Deine Punkte
YourName?=Dein Name?
MakeYouReadyForLevel=Mach Dich für das Level {0} fertig!
HUDScore=Punkte: {0}/{1}
HUDTime=Zeit: {0}
HUDLives=Leben: {0}
HUDHealth=Stärke: {0}
LevelEndTitle=Level beendet
LevelEndScore=Punkte: {0}
LevelEndScoreBonus=Bonus: {0}
LevelEndTime=Zeit: {0}
LevelEndTimeBonus=Zeit Bonus: {0}
GameOver=Verloren
GreenKey=Grüner Schlüssel
Effects=Effekte